10
G#........
##........
..........
..........
..........
..........
..........
..........
..........
.........S
