20
##########.........#
...........#######G#
..#################.
......####........#.
#####.####....#####.
#.....####....#####.
#.########.......##.
#.########.......##.
#................##.
#........S....#####.
#..##########.#####.
#..##.......#.#.#.#.
#...........#.....#.
#..##.......#.....#.
#..##############.#.
#..##..........#..#.
#..##..........#.##.
#.................#.
#.#.#..........#..#.
#################...
