20
##########........##
...........#######G#
..###############.#.
......####........#.
#####.####....#####.
#.....####....#####.
#.########.......##.
#.########.......##.
#................##.
#........S....#####.
#..##########.#####.
#..##.......#.#.#.#.
#...........#.....#.
#..##.......#.....#.
##.################.
#.................#.
#..################.
#.............##..#.
#.#.#.#.#.#.#...#.#.
#############.#.....
